E0000E0E0L0000E0000E
S5050505T11T5050505S
0505E5050110505E5050
05050505511550505050
05050500011000505050
05050555011055505050
0505S0000110000S5050
05055550011005555050
15000000111100000051
12222322211222322221
00100100100100100100
01001001055010010010
000100105AA501001000
00100105000050100100
00001050055005010000
00010500500500501000
00105005044050050100
00003000000000030000
05553300111000335550
05L53330161M03335L50

