E00000000EE00000000E
100E005500005500E001
10A00155555555100A01
1011010011T100101101
10500S01011010S00501
11111111111111111111
13335000500500053331
10105010511501050101
1010500E5005E0050101
12222222222222222221
001001E001100E100100
55002222222222220055
11003302200220330011
00440000555500004400
53311001155110011335
53311015055051011335
01144200111100244110
001L51100M001150L100
22005400111004500110
10011050161005011001
